13 13 00 0048
1 1 1 1 1 1 1 1 1 1 1
22 01 01 22 01 01 22 01 01 22 01 32 35
01 00 00 01 00 00 01 00 00 01 00 00 32
01 00 00 01 00 00 01 00 00 01 00 00 01
22 01 01 22 01 01 22 01 01 22 01 01 22
01 00 00 01 00 00 01 00 00 01 00 00 01
01 00 00 01 00 00 01 00 00 01 00 00 01
22 01 01 22 01 01 22 01 01 22 01 01 22
01 00 00 01 00 00 01 00 00 01 00 00 01
01 00 00 01 00 00 01 00 00 01 00 00 01
22 01 01 22 01 01 22 01 01 22 01 01 22
01 00 00 01 00 00 01 00 00 01 00 00 01
01 00 00 01 00 00 01 00 00 01 00 00 01
34 01 01 22 01 01 22 01 01 22 01 01 22
01 00
02
09 06
11 00
12 01
00
00