08 11 00 0064
1 1 1 1 1 0 1 1 0 1 1
01 01 11 00 11 00 00 00
15 35 11 00 01 00 01 11
01 13 01 06 01 00 01 00
00 00 01 00 01 00 01 00
00 00 01 00 01 00 01 00
00 11 33 01 01 01 01 00
00 01 00 00 00 00 01 00
01 01 01 01 01 11 01 00
01 00 01 00 00 00 01 00
01 00 01 01 01 01 01 00
11 00 00 00 34 00 00 00
00 00
00
00