18 15 01 0090
1 1 1 1 1 0 0 1 0 1 1
01 01 01 01 35 00 00 00 00 00 00 00 00 00 00 00 00 00
01 00 00 00 00 00 00 00 34 01 01 01 00 00 00 00 00 00
10 00 00 00 00 00 00 00 01 00 00 01 00 00 00 00 00 00
01 00 00 00 00 00 00 00 01 00 00 01 00 00 00 00 00 00
01 00 00 00 00 00 00 00 01 01 01 01 01 01 01 01 10 01
01 00 00 00 00 00 00 00 33 00 00 00 00 00 00 00 00 01
01 00 00 00 00 00 00 00 01 00 00 00 00 00 00 00 00 01
01 00 00 00 00 00 00 00 01 00 00 00 00 00 00 00 00 01
01 01 01 01 01 10 01 33 01 01 01 01 00 00 00 00 00 01
01 00 00 00 01 00 00 00 00 00 00 33 00 00 00 00 00 11
01 00 00 00 01 00 00 00 00 00 00 01 00 00 00 00 00 01
01 00 00 00 01 00 00 00 00 00 00 01 01 01 01 01 01 01
01 00 00 00 11 00 00 00 00 00 00 00 00 01 00 00 00 01
01 00 00 00 11 00 00 00 00 00 00 00 00 01 00 00 00 01
01 01 01 01 01 01 01 01 01 01 01 01 01 01 01 01 01 01
00 00
00
00