24 19 01 0140
1 1 1 1 1 1 1 1 1 1 1
00 00 00 00 00 00 00 00 00 00 00 00 00 00 00 00 00 00 00 01 01 01 01 01
00 00 00 00 00 00 00 00 00 00 00 00 00 00 00 00 00 00 00 34 01 01 01 01
00 00 00 00 00 00 00 00 00 00 00 00 00 00 00 00 00 00 00 01 01 01 01 01
00 00 00 00 00 00 00 00 00 00 00 00 00 00 00 00 00 00 00 00 33 33 37 00
12 01 01 01 01 01 01 01 01 01 01 01 01 01 01 33 33 01 01 01 01 01 01 15
12 01 01 01 01 01 01 01 01 01 01 01 01 01 02 33 33 02 01 01 01 01 01 15
12 01 01 01 01 01 01 01 01 01 01 01 01 01 02 33 33 02 01 01 01 01 01 15
12 01 01 01 01 01 01 01 01 01 01 01 01 01 01 33 33 01 01 01 01 01 01 15
12 01 01 01 01 01 01 01 20 01 01 01 01 01 01 33 33 01 01 01 01 01 01 15
12 01 01 01 15 10 10 10 10 10 01 01 01 15 10 10 10 10 10 12 02 02 02 15
12 01 01 01 15 10 10 10 10 10 01 01 01 15 10 10 10 10 10 12 03 03 03 15
12 01 01 01 15 10 10 10 10 10 01 01 01 15 10 10 10 10 10 12 03 03 03 15
12 01 01 01 15 10 10 10 10 10 01 01 01 15 10 10 10 10 10 12 02 04 04 15
12 01 01 01 01 01 01 01 01 01 01 03 02 03 01 01 01 01 01 01 03 03 02 15
12 01 01 01 02 02 02 02 03 01 01 01 03 03 32 32 32 32 32 32 32 32 32 32
12 01 01 01 02 02 03 03 10 03 01 17 17 16 16 16 16 32 10 10 16 16 16 35
12 01 01 01 02 02 03 03 03 02 01 17 17 16 16 16 16 32 16 16 16 16 16 16
12 01 01 01 02 02 02 02 03 03 01 02 03 32 32 32 32 32 32 32 32 32 32 32
12 01 01 01 01 01 01 01 01 01 01 01 01 01 01 01 01 01 01 01 01 01 01 01
01 00
02
08 08
17 15
17 16
00
00