18 09 01 1024
1 1 1 1 1 1 1 1 1 1 1
02 13 13 13 13 02 03 02 13 13 13 13 13 13 02 11 01 01
12 02 14 14 02 15 11 12 02 02 11 02 11 02 15 11 01 25
12 15 01 01 12 04 01 04 02 11 14 14 11 11 15 11 01 01
12 15 01 01 12 03 11 03 11 15 01 01 12 02 15 11 01 01
12 39 01 34 12 04 18 04 02 15 01 35 12 11 15 11 01 01
12 15 01 01 12 03 11 03 11 15 01 01 12 02 15 11 01 01
12 15 01 01 12 04 02 04 02 11 32 32 11 11 15 11 01 01
12 02 13 13 02 15 11 12 11 02 11 02 11 02 15 11 01 20
02 14 14 14 14 02 03 02 14 14 14 14 14 14 02 11 01 01
02 00
02
17 07
10 06
11 06
11 04
01
06 04
11 04
00
00
00