44 41 00 0812
1 1 1 1 0 1 1 1 1 1 1
00 00 00 00 00 00 00 00 00 00 00 00 00 03 03 03 03 03 03 03 03 03 03 00 00 00 00 00 00 00 00 00 00 00 00 00 00 00 00 00 00 00 00 00
00 00 00 00 00 00 00 00 00 00 00 00 00 03 01 01 01 35 01 01 01 01 03 00 00 00 00 00 00 00 00 00 00 00 00 00 00 00 00 00 00 00 00 00
00 00 00 00 00 00 00 00 00 00 00 00 00 03 01 01 01 01 01 01 01 01 03 00 00 00 00 00 00 00 00 00 00 00 00 00 00 00 00 00 00 00 00 00
00 00 00 00 00 00 00 00 00 00 00 00 00 03 01 01 01 01 01 01 01 01 03 00 00 00 00 00 00 00 00 00 00 00 00 00 00 00 00 00 00 00 00 00
00 00 00 00 00 00 00 00 00 00 00 00 00 03 11 11 11 17 17 11 11 11 03 00 00 00 00 00 00 00 00 00 00 00 00 00 00 00 00 00 00 00 00 00
00 00 00 00 00 00 00 00 00 00 00 00 00 03 11 11 11 17 17 11 11 11 03 00 00 00 00 00 00 00 00 00 00 00 00 00 00 00 00 00 00 00 00 00
00 00 00 00 00 00 00 00 00 00 00 00 00 03 11 11 11 17 17 11 11 11 03 00 00 00 00 00 00 00 00 00 00 00 00 00 00 00 00 00 00 00 00 00
00 00 00 00 00 00 00 00 00 00 00 00 00 03 16 16 16 10 10 16 16 16 03 03 03 03 03 03 03 03 03 00 00 00 00 00 00 00 00 00 00 00 00 00
00 00 00 00 00 00 00 00 00 00 00 00 00 03 16 16 10 16 16 10 16 16 32 01 01 24 01 01 01 01 03 00 00 00 00 00 00 00 00 00 00 00 00 00
00 00 00 00 00 00 00 00 00 00 00 00 00 03 10 16 16 16 16 16 01 10 32 01 01 01 01 01 01 01 03 00 00 00 00 00 00 00 00 00 00 00 00 00
00 00 00 00 00 00 00 00 00 00 00 00 00 03 16 16 03 03 16 03 03 21 32 01 01 01 01 18 01 01 03 00 00 00 00 00 00 00 00 00 00 00 00 00
00 00 00 00 00 00 00 00 00 00 00 00 00 03 16 16 03 03 16 03 03 16 32 01 01 01 01 01 01 01 03 00 00 00 00 00 00 00 00 00 00 00 00 00
00 00 00 00 00 00 00 00 00 00 00 00 00 03 16 01 01 01 16 01 01 16 32 01 01 01 01 01 01 01 03 00 00 00 00 00 00 00 00 00 00 00 00 00
03 03 03 03 03 03 03 03 03 03 03 03 03 03 01 01 01 01 01 01 01 01 32 32 32 32 32 32 32 32 03 00 00 00 00 00 00 00 00 00 00 00 00 00
03 01 01 01 01 01 10 01 03 01 10 01 01 32 02 02 02 02 02 02 02 03 32 01 01 01 01 01 01 01 03 00 00 00 00 00 00 00 00 00 00 00 00 00
03 01 01 01 01 01 10 01 03 01 10 01 01 32 02 10 03 03 10 02 10 02 32 01 01 01 01 01 01 01 03 00 00 00 00 00 00 00 00 00 00 00 00 00
03 01 01 01 01 01 03 01 03 01 03 01 01 32 03 02 04 04 04 04 04 04 32 01 01 01 01 20 01 01 03 00 00 00 00 00 00 00 00 00 00 00 00 00
03 01 01 01 01 01 03 01 10 01 03 01 01 32 02 03 03 04 04 03 03 03 32 01 01 01 01 01 01 01 03 00 00 00 00 00 00 00 00 00 00 00 00 00
03 01 01 01 01 01 03 01 10 01 03 01 20 32 01 02 02 03 03 02 02 02 32 01 01 01 01 01 01 01 03 00 00 00 00 00 00 00 00 00 00 00 00 00
03 12 16 16 16 16 03 03 03 03 03 03 03 32 01 01 01 02 02 02 02 01 32 01 01 01 01 01 01 01 03 00 00 00 00 00 00 00 00 00 00 00 00 00
03 12 16 01 16 10 01 01 01 01 01 01 01 32 01 01 01 01 01 01 01 01 32 32 32 32 32 32 32 32 03 03 03 03 03 03 03 03 03 03 03 03 03 03
03 12 10 16 16 16 01 01 01 01 01 01 01 32 18 01 01 01 01 01 01 01 01 01 01 01 19 01 01 01 32 01 01 01 06 01 06 01 13 13 13 13 13 03
03 12 16 16 10 16 01 01 01 01 01 01 01 32 01 01 01 01 01 01 01 01 01 01 01 01 01 01 01 01 32 01 01 01 06 01 06 01 16 16 16 16 15 03
03 12 10 01 16 16 01 01 01 01 01 01 01 32 01 01 01 01 01 01 01 01 01 01 01 01 01 01 01 01 32 01 01 01 06 01 06 01 16 01 16 16 15 03
03 03 03 03 03 03 03 03 03 03 03 03 03 03 03 03 32 32 32 32 32 32 32 01 01 01 01 26 01 01 32 18 01 01 06 01 06 01 16 16 16 10 15 03
00 00 00 00 00 00 00 00 00 00 00 00 00 00 00 03 01 01 01 01 01 01 32 01 01 01 01 01 01 01 32 03 03 03 03 03 03 03 03 16 16 16 15 03
00 00 00 00 00 00 00 00 00 00 00 00 00 00 00 03 01 01 01 01 01 01 32 01 01 01 01 01 01 01 32 01 01 01 01 01 01 01 03 16 16 16 15 03
00 00 00 00 00 00 00 00 00 00 00 00 00 00 00 03 01 01 01 01 01 01 32 01 01 01 01 01 01 01 32 01 01 01 01 01 01 01 03 16 16 01 15 03
00 00 00 00 00 00 00 00 00 00 00 00 00 00 00 03 01 01 01 01 01 01 32 18 01 01 01 01 01 21 32 01 01 01 01 01 01 01 03 16 16 01 15 03
00 00 00 00 00 00 00 00 00 00 00 00 00 00 00 03 01 01 01 01 01 01 32 01 01 01 01 01 01 01 32 01 01 01 01 01 01 01 16 16 16 16 15 03
00 00 00 00 00 00 00 00 00 00 00 00 00 00 00 03 01 01 01 01 01 01 32 01 01 01 01 01 01 01 32 01 01 01 01 01 01 01 16 16 10 16 15 03
00 00 00 00 00 00 00 00 00 00 00 00 00 00 00 03 01 01 01 03 03 03 32 01 01 01 01 01 01 01 32 32 32 32 32 32 32 32 32 32 32 32 32 03
00 00 00 00 00 00 00 00 00 00 00 00 00 00 00 03 01 01 01 01 01 01 32 01 01 01 01 01 01 01 32 01 01 01 01 01 01 03 01 01 01 01 01 03
00 00 00 00 00 00 00 00 00 00 00 00 00 00 00 03 03 03 03 01 01 01 32 01 01 01 01 01 01 01 32 01 01 01 01 01 01 03 01 01 01 01 01 03
00 00 00 00 00 00 00 00 00 00 00 00 00 00 00 03 01 01 01 01 01 01 32 01 01 01 01 01 01 01 32 01 01 01 01 01 01 01 01 01 03 01 01 03
00 00 00 00 00 00 00 00 00 00 00 00 00 00 00 03 01 01 01 03 03 03 32 01 01 01 01 01 01 01 32 01 01 01 01 01 03 03 03 03 03 01 01 03
00 00 00 00 00 00 00 00 00 00 00 00 00 00 00 03 01 01 01 01 01 01 32 01 01 01 01 01 01 01 32 18 01 01 01 01 03 01 01 01 03 01 01 03
00 00 00 00 00 00 00 00 00 00 00 00 00 00 00 03 03 03 03 01 01 01 32 01 01 01 01 01 01 01 32 01 01 01 01 01 03 34 01 01 03 01 01 03
00 00 00 00 00 00 00 00 00 00 00 00 00 00 00 03 01 19 01 01 01 01 32 01 01 01 01 01 01 01 32 01 01 01 01 01 03 01 01 01 01 01 01 03
00 00 00 00 00 00 00 00 00 00 00 00 00 00 00 03 01 01 01 01 01 01 32 01 01 01 01 01 01 01 32 01 01 01 01 21 03 01 01 01 01 01 01 03
00 00 00 00 00 00 00 00 00 00 00 00 00 00 00 03 03 03 03 03 03 03 03 03 03 03 03 03 03 03 03 03 03 03 03 03 03 03 03 03 03 03 03 03
13 00
04
31 24
14 04
15 04
16 04
17 01
04
17 38
19 05
20 05
21 05
17 01
04
27 16
14 06
15 06
16 06
17 01
04
12 18
19 04
20 04
21 04
17 01
04
29 08
14 05
15 05
16 05
17 01
04
35 39
19 06
20 06
21 06
17 01
04 
14 21
13 20
13 21
13 22
13 23
05 
21 10
22 08
22 09
22 10
22 11
22 12
04 
23 28
22 27
22 28
22 29
22 30
07 
26 21
23 20
24 20
25 20
26 20
27 20
28 20
29 20
05 
29 28
30 26
30 27
30 28
30 29
30 30
08 
31 36
30 32
30 33
30 34
30 35
30 36
30 37
30 38
30 39
04
27 10
14 05
15 05
16 05
17 01
00
00