24 06 00 0096
1 1 1 1 1 1 1 1 1 1 1
40 01 40 00 00 40 01 01 40 00 00 40 01 01 40 00 00 01 01 01 40 00 00 40
01 00 01 00 00 01 00 00 01 00 00 01 00 00 01 00 00 01 00 00 00 00 00 01
01 00 01 00 00 01 00 00 01 00 00 01 00 00 01 00 00 01 00 00 00 00 00 01
01 01 40 00 00 01 00 00 01 00 00 01 00 00 01 00 00 01 01 40 00 00 00 40
01 00 00 00 00 01 00 00 01 00 00 01 00 00 01 00 00 01 00 00 00 00 00 00
34 00 00 00 00 40 01 01 40 00 00 40 01 01 40 00 00 01 00 00 00 00 00 35
00 15
00 00
12 00
02 00
17 00
05 00
06 00
08 00
13 00
14 00
07 00
20 00
02 14
23 00
23 05
11 00
08 02
02 03
05 03
19 03
23 02
23 03
00 05
05 05
00 04
08 05
12 05
11 05
07 05
14 05
02 01
00
00