11 17 00 1024
1 1 1 1 1 1 1 1 1 1 1
40 01 01 01 01 01 01 01 01 01 01
01 00 01 01 01 02 01 03 11 04 01
01 01 01 01 01 01 01 01 01 01 01
01 05 01 06 01 07 01 08 01 09 01
01 01 01 01 01 01 01 01 01 01 01
01 10 01 11 01 12 01 13 01 14 01
01 01 01 01 01 01 01 01 01 01 01
01 15 01 16 01 17 01 18 01 19 01
01 01 01 01 01 01 01 01 01 01 01
01 20 01 21 01 22 01 23 01 24 01
01 01 01 01 01 01 01 01 01 01 01
01 25 01 26 01 27 01 28 05 29 01
01 01 01 01 01 01 01 01 04 01 01
01 30 01 31 01 32 01 33 03 01 01
01 01 01 01 01 01 01 01 02 14 01
01 35 01 36 01 37 01 38 27 39 01
01 01 01 01 01 01 01 32 34 01 32
00 00
00
00
00