09 18 00 1024
1 1 1 1 1 1 1 1 1 1 1
00 00 00 00 00 00 00 00 00
00 00 00 00 00 00 00 00 00
00 00 00 00 00 00 00 00 00
00 00 00 00 00 00 00 00 00
00 00 00 00 00 00 00 00 00
00 00 00 00 00 00 00 00 00
00 00 00 00 00 00 00 00 00
00 00 00 00 00 00 00 00 00
00 00 00 00 00 00 00 00 00
00 00 00 00 00 00 00 00 00
00 00 00 00 00 00 00 00 00
00 00 00 00 00 10 00 00 00
00 00 39 01 10 16 00 00 00
00 00 00 00 00 16 00 00 00
00 00 00 00 00 16 00 00 00
00 00 00 00 00 16 00 00 00
00 00 00 00 00 34 00 00 00
00 00 00 00 00 20 00 35 00
00 01
00 00
07 17
00
05
02
05 17
06 16 21
01 12 18
01
06 16
05 11 32
15
01 12
06 12 01
07 12 01
08 12 01
08 11 01
08 10 01
08 09 01
07 09 01
06 09 01
05 09 01
05 08 01
05 07 01
05 06 01
06 06 01
07 06 01
08 06 21
17
08 06
04 06 01
03 06 02
02 06 03
02 05 03
03 05 03
01 06 04
01 05 04
01 04 04
02 04 04
03 04 04
00 06 05
00 05 05
00 04 05
00 03 22
01 03 05
02 03 05
03 03 05
03
00 03
00 02 01
00 01 01
00 00 40



