11 18 03 1024
1 1 1 1 1 1 1 1 1 1 1
33 16 16 16 16 16 16 16 16 16 33
16 01 16 16 33 16 16 16 33 16 16
10 10 10 16 16 16 22 16 16 16 16
10 22 10 16 16 16 16 16 16 16 16
10 10 10 33 16 16 16 16 16 33 16
00 01 00 16 16 16 33 16 16 16 16
00 01 00 16 16 16 16 16 16 16 16
00 01 00 16 10 16 16 16 16 16 16
00 01 00 33 16 16 16 16 16 16 16
00 01 00 33 16 16 16 16 16 33 16
00 01 10 01 00 00 00 00 00 00 00
00 00 00 01 01 01 34 00 00 00 00
00 00 00 00 11 11 11 11 11 00 00
00 00 00 00 11 11 11 11 11 00 00
00 00 00 00 11 11 35 11 11 00 00
00 00 00 00 11 11 11 11 11 00 00
00 00 00 00 11 11 11 11 11 00 00
00 00 00 00 00 00 00 00 00 00 00
02 00
25
01 03
04 12
05 12
06 12
07 12
08 12
04 13
05 13
06 13
07 13
08 13
04 14
05 14
06 14
07 14
08 14
04 15
05 15
06 15
07 15
08 15
04 16
05 16
06 16
07 16
08 16
01
06 02
06 14
00
00