10 12 01 0412
1 1 1 1 1 1 1 1 1 1 1
34 16 16 11 01 00 13 13 31 19
16 00 01 16 11 00 01 01 01 29
16 01 01 00 16 00 01 32 01 13
11 01 00 00 01 00 01 32 32 01
01 11 16 16 10 32 10 01 01 01
00 00 00 00 01 01 32 00 00 00
00 00 00 00 01 01 32 00 00 18
01 01 01 01 10 32 10 01 01 29
01 01 00 01 01 00 01 14 14 14
01 01 00 00 00 00 14 14 14 01
14 14 14 14 01 00 01 14 14 14
20 01 01 01 01 00 32 11 11 35
03 00
03
00 11
05 04
06 05
09 11
04
09 00
07 11
08 11
06 06
05 07
04
09 06
09 11
06 09
09 10
06 11
00
00
00