10 09 01 1024
1 1 1 1 1 1 1 1 1 1 1
18 01 10 10 04 10 03 02 01 19
10 01 10 10 10 10 10 11 11 11
01 10 02 03 04 10 03 11 11 11
10 02 10 10 10 10 10 11 11 32
34 01 02 10 04 10 03 11 32 35
10 02 10 10 10 10 10 11 11 32
01 10 02 10 04 10 03 11 11 11
10 01 10 10 10 10 10 11 11 11
20 01 10 01 04 10 01 10 01 21
04 00
04
00 08
09 05
09 04
08 07
08 02
04
00 00
09 03
07 06
09 04
07 01
06
09 08
08 04
07 03
08 06
07 07
09 04
08 01
12
09 00
09 04
09 01
09 07
07 05
08 03
07 04
09 06
07 02
08 05
09 02
09 03
09 05
00
00
00