14 14 02 0160
1 1 1 1 1 1 1 1 1 1 1
00 00 22 16 16 16 16 16 16 16 10 10 10 40
00 00 01 00 00 00 00 00 00 00 00 00 00 01
00 00 01 00 40 00 11 35 00 16 16 40 00 01
00 00 01 01 33 00 11 11 00 16 00 00 00 01
00 00 00 00 00 00 00 00 00 16 00 00 00 07
00 00 00 00 16 16 16 16 16 16 00 00 00 01
34 00 27 01 00 00 00 00 00 00 00 00 00 33
01 00 02 02 00 00 00 00 19 00 19 00 00 01
10 00 03 03 00 00 00 01 33 01 33 01 00 01
01 00 04 04 00 00 00 00 01 01 01 00 00 01
38 00 01 20 00 00 39 39 33 01 33 01 00 10
01 00 00 00 40 39 37 00 20 00 20 00 00 10
01 00 00 00 00 00 00 00 00 00 00 00 00 01
40 10 10 10 01 01 01 01 01 01 01 01 01 40
05 07
01
08 11
05 11
01
10 11
06 11
01
08 07
06 10
01
10 07
07 10
03
02 00
06 02
06 03
07 03
00 13
09 09
13 13
02 06
13 00
04 05
04 11
04 13
03 06
13 09
11 02
09 00
04 02
06 02
00
01
07
03 10
03 09 01
02 09 01
03 08 01
02 08 01
03 07 01
02 07 01
03 06 40
00