10 08 00 1024
1 1 1 1 1 1 1 1 1 1 1
00 00 00 00 35 00 00 00 00 00
00 00 00 00 00 00 00 00 00 00
00 00 00 00 00 00 00 00 00 00
00 00 00 00 00 00 00 00 00 00
00 00 00 00 00 00 00 00 00 00
00 00 00 00 00 00 00 00 00 00
00 00 00 00 22 00 00 00 00 00
00 00 00 00 34 00 00 00 00 00
01 00
01
04 01
04 00
01
04 00
01
05
04 06
04 05 01
04 04 01
04 03 01
04 02 01
04 01 22