26 14 00 0032
1 0 1 1 0 0 0 0 0 1 1
00 00 00 00 00 00 00 00 00 00 00 00 00 00 00 00 00 00 00 00 00 00 00 00 00 00
00 00 00 35 00 00 00 00 00 40 00 00 00 00 00 00 40 00 00 00 00 00 40 00 00 00
00 00 00 01 00 00 00 00 00 01 00 00 00 00 00 00 01 00 00 00 00 00 01 00 00 00
00 40 01 01 01 40 00 40 01 01 01 40 00 00 40 01 01 01 40 00 40 01 01 01 40 00
00 00 00 01 00 00 00 00 00 01 00 00 00 00 00 00 01 00 00 00 00 00 01 00 00 00
00 00 00 40 00 00 00 00 00 40 00 00 00 00 00 00 40 00 00 00 00 00 40 00 00 00
00 00 00 00 00 00 00 00 00 00 00 00 00 00 00 00 00 00 00 00 00 00 00 00 00 00
00 00 00 00 00 00 00 00 00 00 00 00 00 00 00 00 00 00 00 00 00 00 00 00 00 00
00 00 00 40 00 00 00 00 00 40 00 00 00 00 00 00 40 00 00 00 00 00 40 00 00 00
00 00 00 01 00 00 00 00 00 01 00 00 00 00 00 00 01 00 00 00 00 00 01 00 00 00
00 40 01 01 01 40 00 40 01 01 01 40 00 00 40 01 01 01 40 00 40 01 01 01 40 00
00 00 00 01 00 00 00 00 00 01 00 00 00 00 00 00 01 00 00 00 00 00 01 00 00 00
00 00 00 40 00 00 00 00 00 40 00 00 00 00 00 00 40 00 00 00 00 00 34 00 00 00
00 00 00 00 00 00 00 00 00 00 00 00 00 00 00 00 00 00 00 00 00 00 00 00 00 00
00 30
01 03
09 10
01 10
22 10
03 05
03 10
03 08
22 03
03 12
22 10
05 03
09 03
05 10
09 10
07 03
16 03
07 10
03 10
09 01
03 10
09 05
09 10
09 08
09 03
09 12
09 03
11 03
16 10
11 10
16 10
14 03
22 03
14 10
09 10
16 01
22 10
16 05
16 10
16 08
16 03
16 12
03 10
18 03
22 10
18 10
22 10
20 03
09 03
20 10
16 10
22 01
09 10
22 05
03 03
22 08
22 03
24 03
09 10
24 10
03 10
00
00